[syn] --> Various Syntax Error Fixes	NullPatch.txt
[syn] Fix ADBG Error	syntax/fix_ADBG.txt
[syn] Fix PARSEOP_STORE/MMTB/HRPR Error	syntax/fix_MMTB.txt
[syn] Fix PARSEOP_ZERO Error	syntax/fix_PARSEOP_ZERO.txt
[syn] Rename _DSM methods to XDSM	syntax/rename_DSM.txt
[syn] Remove _PSS placeholders	syntax/fix_PSS.txt
[igpu] --> Intel Graphics Patches	NullPatch.txt
[igpu] Brightness fix	graphics/graphics_PNLF.txt
[igpu] Rename GFX0 to IGPU	graphics/graphics_Rename-GFX0.txt
[igpu] Rename B0D3 to HDAU	graphics/graphics_Rename-B0D3.txt
[gfx0] --> Disable Nvidia/Radeon	NullPatch.txt
[gfx0] Cleanup/Fix Errors (SSDT)	graphics/graphics_SSDT-disable-cleanup.txt
[gfx0] Disable from _INI (SSDT)	graphics/graphics_INI-disable.txt
[gfx0] Disable from _REG (DSDT)	graphics/graphics_REG-disable.txt
[gfx0] Disable/Enable on _WAK/_PTS (DSDT)	graphics/graphics_PTS_WAK-disable.txt
[usb] --> USB (ECHI) Patches	NullPatch.txt
[usb] USB3 _PRW 0x6D Skylake (instant wake)	usb/usb_prw_0x6d_xhc_skl.txt
[bat] --> Battery Patches	NullPatch.txt
[bat] ASUS N55SL/VivoBook	battery/battery_ASUS-N55SL.txt
[wifi] --> Atheros WiFi Patches	NullPatch.txt
[wifi] AR9285 WiFi RP02-PXSX	wifi/wifi_AR9285-RP02-PXSX.txt
[wifi] AR9285 WiFi RP02-WLAN	wifi/wifi_AR9285-RP02-WLAN.txt
[wifi] AR9285 WiFi RP02-WNIC	wifi/wifi_AR9285-RP02-WNIC.txt
[sys] --> System Patches	NullPatch.txt
[sys] IRQ Fix	system/system_IRQ.txt
[sys] SMBUS Fix	system/system_SMBUS.txt
[sys] Fix Mutex with non-zero SyncLevel	system/system_Mutex.txt
[sys] Fix PNOT/PPNT	system/system_PNOT.txt
[sys] Add IMEI	system/system_IMEI.txt
[sys] Skylake LPC	misc/misc_Skylake-LPC.txt
[audio] --> Audio	NullPatch.txt
[audio] Audio Layout 3	audio/audio_HDEF-layout3.txt
